#00000000000#
#00$0#000#00#
#00#00#000#0#
#00 000#0000#
#00000000#00#
#@0#0#00000##
####!####!!##
X