#00000000000#
#0000#000#00#
#00$00#000#0#
#00#000#000##
#000000000###
#@00#0#0000##
#########0###
!
